222222222222000
111111111112000
222222222212000
000000000212000
022222222212000
021111111112000
021222222222220
021200002111120
021222222122120
021111111122120
022222222222120
000000000002120
222222222222120
111111111111120
222222222222220

